#########################################################
#S                                                      #
### ### ### ### ### ### ### ### ### ### ### ### ### ### #
  # # # # # # # # # # # # # # # # # # # # # # #E# # # # #
  ### # # # # # # # # # # # # # # # # # # # # # # # # # #
      ### # # # # # # # # # # # # # # # # # # # # # # # #
          ### # # # # # # # # # # # # # # # # # # # # # #
              ### # # # # # # # # # # # # # # # # # # # #
                  ### # # # # # # # # # # # # # # # # # #
                      ### # # # # # # # # # # # # # # # #
                          ### # # # # # # # # # # # # # #
                              ### # # # # # # # # # # # #
                                  ### # # # # # # # # # #
                                      ### # # # # # # # #
                                          ### # # # # # #
                                              ### # # # #
                                                  ### # #
                                                      ###
