###############################
#S    #  #     #              #
# #####  #  #########   ####  #
#     #  #           #     #  #
#  ####  #########   ###   #  #
#     #  #  #  #           #  #
#  ####  #  #  ####  #######  #
#                             #
#  ###############   ###      #
#  #     #           #  #  #  #
####     ######   ####  #  ####
#     #        #  #  #  #  #  #
###   ###      #  #  #  ####  #
#  #        #        #  #  #  #
####  ###   #  ###   #   ######
#           #  #        #     #
#        ####  ###   ####  ####
#########   #  ####  ###   ###################
#        #     #        #      #             #
#        ###   #  ###   #     ###########    #
#  #  #        #     #  #  #                 #
#  ######## ######  #####  #  ####### ########
#     #  #     #              #     # #
#  ####  #  #########   ####  #     # #
#     #  #           #     #  #     # #
#  ####  #########   ###   #  #     # #
#     #  #  #  #           #  #     # #
#  ####  #  #  ####  #######  #     # #
#                             #     # #
#  ###  ##########   ###      #     # #
#  #                 #  #  #  #     # #
####     ######   ####  #  ####     # #
#     #        #  #  #  #  #  #     # #
###   ###      #  #  #  ####  #     # #
#           #  #        #     #     # #
#        ####  ###   ####  ####     # #
#  #  #     #     #     #     #     # #
#  ####  ##################   #     # #
#     #     #        #        #     # #
#######     #     ####  #######     # #
#     #  #     #        #     #     # #
#  #########   #        #  ####     # #
#           #  #  #  #        #     # #
#########   #  ####  ###   ########## ########
#        #     #        #     #              #
#        ###   #  ###   #     ###########    #
#  #  #        #     #  #  #                E#
##############################################
