##########################################################################################
#                                                                                        #
#  S                                                                                E    #
#                                                                                        #
##########################################################################################
